1 100 100
15 15
100 150 200 150 100 200 200 200 150 200 200 100 100 150 100
200 150 100 100 100 200 150 200 200 150 200 100 150 150 150
100 100 100 -1 -1 -1 200 150 200 100 -2 100 100 100 150
100 100 100 -1 -1 200 200 200 150 150 -2 150 200 200
200 150 150 100 150 100 200 200 150 150 150 100 100 150 150
100 -2 -2 100 200 200 100 150 200 100 150 -1 -1 200 200
150 100 100 150 200 200 -2 -2 -2 150 150 200 100 200 200
200 200 100 200 200 200 100 -2 -2 100 100 150 100 150 150
100 -2 150 150 100 200 150 200 150 150 150 150 -1 -1 100
100 100 200 200 200 200 150 200 150 200 200 200 100 100 200
150 100 200 -1 -1 150 100 200 150 -1 -1 -1 200 150 100
150 100 150 -1 150 150 150 150 150 200 -1 -1 200 100 200 200
200 150 100 -1 100 100 200 150 100 200 -1 150 150 200 150
200 200 150 200 150 150 -2 -2 200 100 150 200 -1 100 200
150 100 100 150 100 150 150 200 150 100 100 150 200 100 150
4 4 cap 1 1 20 1
12 12 cap 0 1 20 1